SSSBSSSSSBSSS1
111WT111111111
01PWT100000000
11111110000000
11111110000000
W10WT0W0000000
W11WT000000000
11111100000000
11111100000000
11111100000000
11111100000000
111B111111B111